+------+
|P..1.X|
|....1#|
|..^...|
+------+